111111111111
S00000010111
111111010001
100010011101
101010000101
101110110001
100000111101
111100000011
110001101011
100111100001
10000001110E
111111111111
