111111111111
S00000011111
111111011111
111110011111
111110111111
111110111111
111110111111
111110000011
111111111011
111111111001
11111111110E
111111111111
